默认快捷键列表(可修改)：
设置		F1
发文		F2
重打		F3
载文		F4
换群		F5
发送当前文段	F7
暂停		F8
发送上次成绩	F9
历史记录	Ctrl+H
窗口复位	Ctrl+D
查询当前编码	Ctrl+F
速度分析	Ctrl+G
跟打报告	Ctrl+J
按键统计	Ctrl+K
打开练习	Ctrl+O
测速数据	Ctrl+P
发下一段	Ctrl+R
复制图片成绩	Ctrl+T
停止发文	Ctrl+W
检验真伪	Alt+D
从剪贴板载文	Alt+E
从QQ窗口载文	Alt+S
乱序重打	Ctrl+L
老板键(全局)	Alt+Q

内部快捷键(不可修改)：
载文下一段	Ctrl+右
载文上一段	Ctrl+左